1 10
WWWWWWWW
WP$ W  W
W S W  W
W 3 WG W
W    $ W
W  M   W
WWWWWWWW
